12$34$0$180$0
18$34$0$180$0
12$37$0$180$0
20$37$0$180$0
16$39$0$180$0
