21$23$0$0$0
12$23$0$0$0
19$18$0$0$0
14$18$0$0$0
17$10$0$0$0
