19$40$0$180$0
14$40$0$180$0
19$35$0$180$0
14$35$0$180$0
17$37$0$180$0
